4 4 4 4 4 4 2 2 4 4 6 6 6 6 6
4 2 2 2 4 4 2 2 4 4 6 6 6 6 6
4 2 5 2 5 4 2 2 4 4 6 6 6 6 6
4 5 5 5 5 4 4 4 4 4 6 6 6 6 6
4 4 5 5 4 4 3 4 4 4 6 6 6 6 6
4 6 6 6 6 4 3 2 2 4 6 6 6 2 2
4 6 6 6 6 4 3 3 4 4 6 6 6 6 6
4 6 6 6 6 4 4 3 4 2 4 4 4 4 4
4 3 3 3 3 3 3 3 4 2 3 3 4 4 4
4 3 3 3 3 3 3 3 4 2 3 3 4 4 4
4 4 4 4 4 4 4 4 4 2 2 2 4 4 4
4 4 4 3 4 4 4 4 4 2 2 2 3 3 3
3 3 3 3 3 3 3 3 4 4 4 3 2 4 4
